Drapeau des Émirats arabes unis Émirats arabes unis	Abou Dabi
Drapeau du Nigeria Nigeria	Abuja
Drapeau du Ghana Ghana	Accra
Drapeau du Turkménistan Turkménistan	Achgabat
Drapeau de l'Éthiopie Éthiopie	Addis-Abeba
Drapeau de l'Algérie Algérie	Alger
Drapeau de Niue Niue	Alofi
Drapeau de la Jordanie Jordanie	Amman
Drapeau des Pays-Bas Pays-Bas	Amsterdam
Drapeau d'Andorre Andorre	Andorre-la-Vieille
Drapeau de la Turquie Turquie	Ankara
Drapeau de Madagascar Madagascar	Antananarivo
Drapeau des Samoa Samoa	Apia
Drapeau de l'Érythrée Érythrée	Asmara
Drapeau du Paraguay Paraguay	Asuncion
Drapeau de la Grèce Grèce	Athènes
Drapeau des Îles Cook Îles Cook	Avarua
Drapeau de l'Irak Irak	Bagdad
Drapeau de l'Azerbaïdjan Azerbaïdjan	Bakou
Drapeau du Mali Mali	Bamako
Drapeau du Brunei Brunei	Bandar Seri Begawan
Drapeau de la Thaïlande Thaïlande	Bangkok
Drapeau de la République centrafricaine République centrafricaine	Bangui
Drapeau de la Gambie Gambie	Banjul
Drapeau de Saint-Christophe-et-Niévès Saint-Christophe-et-Niévès	Basseterre
Drapeau de la Serbie Serbie	Belgrade
Drapeau du Belize Belize	Belmopan
Drapeau de l'Allemagne Allemagne	Berlin
Drapeau de la Suisse Suisse	Berne (capitale de facto)3
Drapeau du Liban Liban	Beyrouth
Drapeau du Kirghizistan Kirghizistan	Bichkek
Drapeau de la Guinée-Bissau Guinée-Bissau	Bissau
Drapeau d'Afrique du Sud Afrique du Sud	Bloemfontein (capitale judiciaire)4
Drapeau de la Colombie Colombie	Bogota
Drapeau du Brésil Brésil	Brasilia
Drapeau de la Slovaquie Slovaquie	Bratislava
Drapeau de la république du Congo République du Congo	Brazzaville
Drapeau de la Barbade Barbade	Bridgetown
Drapeau de la Belgique Belgique	Bruxelles
Drapeau de la Roumanie Roumanie	Bucarest
Drapeau de la Hongrie Hongrie	Budapest
Drapeau de l'Argentine Argentine	Buenos Aires
Drapeau de l'Égypte Égypte	Le Caire
Drapeau de l'Australie Australie	Canberra
Drapeau d'Afrique du Sud Afrique du Sud	Le Cap (capitale législative)4
Drapeau du Venezuela Venezuela	Caracas
Drapeau de Sainte-Lucie Sainte-Lucie	Castries
Drapeau de la Moldavie Moldavie	Chisinau
Drapeau du Sri Lanka Sri Lanka	Sri Jayawardenapura Kotte (administrative et législative)5
Drapeau de la Guinée Guinée	Conakry
Drapeau du Danemark Danemark	Copenhague
Drapeau du Sénégal Sénégal	Dakar
Drapeau de la Syrie Syrie	Damas
Drapeau des Îles Marshall Îles Marshall	Delap-Uliga-Darrit (Majuro)6
Drapeau du Bangladesh Bangladesh	Dacca
Drapeau du Timor oriental Timor oriental	Dili
Drapeau de Djibouti Djibouti	Djibouti
Drapeau du Soudan du Sud Soudan du Sud	Djoubanote 1
Drapeau de la Tanzanie Tanzanie	Dodoma
Drapeau du Qatar Qatar	Doha
Drapeau du Tadjikistan Tadjikistan	Douchanbé
Drapeau de l'Irlande Irlande	Dublin
Drapeau de l'Arménie Arménie	Erevan
Drapeau de Sierra Leone Sierra Leone	Freetown
Drapeau des Tuvalu Tuvalu	Funafuti (Vaiaku)7
Drapeau du Botswana Botswana	Gaborone
Drapeau du Guyana Guyana	Georgetown
Drapeau du Burundi Burundi	Gitega
Drapeau du Guatemala Guatemala	Guatemala
Drapeau de la République socialiste du Viêt Nam Viêt Nam	Hanoï
Drapeau du Zimbabwe Zimbabwe	Harare
Drapeau de Cuba Cuba	La Havane
Drapeau de la Finlande Finlande	Helsinki
Drapeau des Îles Salomon Îles Salomon	Honiara
Drapeau du Pakistan Pakistan	Islamabad
Drapeau de l'Indonésie Indonésie	Jakarta
Drapeau d’Israël Israël	Jérusalem (contesté au profit de Tel Aviv-Jaffa)note 2
Drapeau de la Palestine Palestine (État de)12	Jérusalem-Est (capitale proclamée)note 3
Drapeau de l'Afghanistan Afghanistan	Kaboul
Drapeau de l'Ouganda Ouganda	Kampala
Drapeau du Népal Népal	Katmandou
Drapeau du Soudan Soudan	Khartoum
Drapeau de l'Ukraine Ukraine	Kiev
Drapeau du Rwanda Rwanda	Kigali
Drapeau de la Jamaïque Jamaïque	Kingston
Drapeau de Saint-Vincent-et-les-Grenadines Saint-Vincent-et-les-Grenadines	Kingstown
Drapeau de la république démocratique du Congo République démocratique du Congo	Kinshasa
Drapeau des Palaos Palaos	Melekeok24
Drapeau du Koweït Koweït	Koweït
Drapeau de la Malaisie Malaisie	Kuala Lumpur25
Drapeau du Gabon Gabon	Libreville
Drapeau du Malawi Malawi	Lilongwe
Drapeau du Pérou Pérou	Lima
Drapeau du Portugal Portugal	Lisbonne
Drapeau de la Slovénie Slovénie	Ljubljana
Drapeau du Togo Togo	Lomé
Drapeau du Royaume-Uni Royaume-Uni	Londres
Drapeau de l'Angola Angola	Luanda
Drapeau de la Zambie Zambie	Lusaka
Drapeau du Luxembourg Luxembourg	Luxembourg
Drapeau de l'Espagne Espagne	Madrid
Drapeau de la Guinée équatoriale Guinée équatoriale	Malabo
Drapeau des Maldives Maldives	Malé
Drapeau du Nicaragua Nicaragua	Managua
Drapeau de Bahreïn Bahreïn	Manama
Drapeau des Philippines Philippines	Manille
Drapeau du Mozambique Mozambique	Maputo
Drapeau d'Oman Oman	Mascate
Drapeau du Lesotho Lesotho	Maseru
Drapeau de l'Eswatini Eswatini (Swaziland)	Mbabane
Drapeau du Mexique Mexique	Mexico
Drapeau de la Biélorussie Biélorussie	Minsk
Drapeau de la Somalie Somalie	Mogadiscio (Muqdisho26)
Drapeau de Monaco Monaco	Monaco
Drapeau du Libéria Liberia	Monrovia
Drapeau de l'Uruguay Uruguay	Montevideo
Drapeau des Comores Comores	Moroni
Drapeau de la Russie Russie	Moscou
Drapeau du Kenya Kenya	Nairobi
Drapeau des Bahamas Bahamas	Nassau
Drapeau de la Birmanie Birmanie (Myanmar)	Naypyidaw 27
Drapeau du Tchad Tchad	N'Djaména
Drapeau de l'Inde Inde	New Delhi
Drapeau du Niger Niger	Niamey
Drapeau de Chypre Chypre	Nicosie
Drapeau de la Mauritanie Mauritanie	Nouakchott
Drapeau du Kazakhstan Kazakhstan	Noursoultan28
Drapeau des Tonga Tonga	Nuku'alofa
Drapeau de la Norvège Norvège	Oslo
Drapeau du Canada Canada	Ottawa
Drapeau du Burkina Faso Burkina Faso	Ouagadougou
Drapeau de la Mongolie Mongolie	Oulan-Bator
Drapeau des États fédérés de Micronésie États fédérés de Micronésie	Palikir
Drapeau du Panama Panama	Panama
Drapeau du Suriname Suriname	Paramaribo
Drapeau de la France France	Paris
Drapeau de la Bolivie Bolivie	La Paz (gouvernement et ambassades)29
Drapeau de la République populaire de Chine Chine	Pékin
Drapeau du Cambodge Cambodge	Phnom Penh
Drapeau du Monténégro Monténégro	Podgorica
Drapeau de la Papouasie-Nouvelle-Guinée Papouasie-Nouvelle-Guinée	Port Moresby
Drapeau d'Haïti Haïti	Port-au-Prince
Drapeau de Trinité-et-Tobago Trinité-et-Tobago	Port-d'Espagne
Drapeau de Maurice Maurice	Port-Louis
Drapeau du Bénin Bénin	Porto-Novo (administrative)30
Drapeau du Vanuatu Vanuatu	Port-Vila
Drapeau de la Tchéquie République tchèque	Prague
Drapeau du Cap-Vert Cap-Vert	Praia
Drapeau d'Afrique du Sud Afrique du Sud	Pretoria (capitale administrative)4
Drapeau de la Malaisie Malaisie	Putrajaya (capitale administrative)25
Drapeau de la Corée du Nord Corée du Nord	Pyongyang
Drapeau de l'Équateur Équateur	Quito
Drapeau du Maroc Maroc	Rabat
Drapeau de la Palestine Palestine (État de)12	Ramallah (capitale de facto)note 3
Drapeau de l'Islande Islande	Reykjavik
Drapeau de la Lettonie Lettonie	Riga
Drapeau de l'Arabie saoudite Arabie saoudite	Riyad
Drapeau de l'Italie Italie	Rome
Drapeau de la Dominique Dominique	Roseau
Drapeau d'Antigua-et-Barbuda Antigua-et-Barbuda	Saint John's
Drapeau de la République dominicaine République dominicaine	Saint-Domingue
Drapeau de Grenade Grenade	Saint-Georges
Drapeau de Saint-Marin Saint-Marin	Saint-Marin
Drapeau du Costa Rica Costa Rica	San José
Drapeau du Salvador Salvador	San Salvador
Drapeau du Yémen Yémen	Sanaa
Drapeau du Chili Chili	Santiago
Drapeau de Sao Tomé-et-Principe Sao Tomé-et-Principe	São Tomé
Drapeau de la Bosnie-Herzégovine Bosnie-Herzégovine	Sarajevo
Drapeau de la Corée du Sud Corée du Sud	Séoul
Drapeau de Singapour Singapour	Singapour
Drapeau de la Macédoine du Nord Macédoine du Nord	Skopje
Drapeau de la Bulgarie Bulgarie	Sofia
Drapeau de la Suède Suède	Stockholm
Drapeau de la Bolivie Bolivie	Sucre (constitutionnelle)29
Drapeau des Fidji Fidji	Suva
Drapeau de l'Ouzbékistan Ouzbékistan	Tachkent
Drapeau de l'Estonie Estonie	Tallinn
Drapeau des Kiribati Kiribati	Tarawa-Sud31
Drapeau de la Géorgie Géorgie	Tbilissi
Drapeau du Honduras Honduras	Tegucigalpa
Drapeau de l'Iran Iran	Téhéran
Drapeau du Bhoutan Bhoutan	Thimphou
Drapeau de l'Albanie Albanie	Tirana
Drapeau du Japon Japon	Tokyo
Drapeau de la Libye Libye	Tripoli
Drapeau de la Tunisie Tunisie	Tunis
Drapeau du Liechtenstein Liechtenstein	Vaduz
Drapeau de Malte Malte	La Valette
Drapeau de la Pologne Pologne	Varsovie
Drapeau du Vatican Vatican	Cité du Vatican
Drapeau des Seychelles Seychelles	Victoria
Drapeau de l'Autriche Autriche	Vienne
Drapeau du Laos Laos	Vientiane
Drapeau de la Lituanie Lituanie	Vilnius
Drapeau des États-Unis États-Unis	Washington D.C.
Drapeau de la Nouvelle-Zélande Nouvelle-Zélande	Wellington
Drapeau de la Namibie Namibie	Windhoek
Drapeau de la Côte d'Ivoire Côte d'Ivoire	Yamoussoukro32
Drapeau du Cameroun Cameroun	Yaoundé
Drapeau de Nauru Nauru	Yaren (capitale de facto)
Drapeau de la Croatie Croatie	Zagreb